31000000000000000001
10000000000000000000
00000000000000000000
00011111111111111110
00013333333333333310
00133333333333333310
00013333333333333310
00013333333333333310
00013333333333333310
00013333333333333310
00013333333333333310
00013333333333333310
00013333333333333310
00013333333333333310
00013333333333333310
00011111113111111110
00000000001000000000
00000000001000000000
00000000001000000000
00000000001000000000
